b=5D9A44
d=2F6330
l=A6D864
a=6E4A28
.=00000000

. . . . . . . . . . . . . . . .
. . . . . . . . . . . . . . . .
. . . . . . . . . . . . . . . .
. . . . . . . . . . . . . . . .
. . . . . . . . . . . . . . . .
. . . . . . . . . . . . . . . .
. . . . . . . . . . . . . . . .
. . . . . . . . . . . . . . . .
. . . . . . l b d b l . . . . .
. . . . . . . . d . . . . . . .
. . . . . . l b d b l . . . . .
. . . . . . . . d . . . . . . .
. . . . . . l b d b l . . . . .
. . . . . . . . d . . . . . . .
. . . . . . l b d b l . . . . .
. . . . . . . . . . . . . . . .
