b=3F8A35
d=234F25
l=C63E2E
a=5D3922
.=00000000

. . . . . . . . . . . . . . . .
. . . . . . . . . . . . . . . .
. . . . . . . . . . . . . . . .
. . . . . . . . . . . . . . . .
. . . . . . . . . . . . . . . .
. . . . . . . . . . . . . . . .
. . . . . . . . . . . . . . . .
. . . . . . . . d . . . . . . .
. . . . . l b b d b b l . . . .
. . . . . . . . d . . . . . . .
. . . . . l b b d b b l . . . .
. . . . . . . . d . . . . . . .
. . . . . l b b d b b l . . . .
. . . . . . . . d . . . . . . .
. . . . . l b b d b b l . . . .
. . . . . . . . . . . . . . . .
